11111111111
100C1000011
1PE00C00C01
11111111111