1111111111
10001000E1
1P10000001
1111111111
