1111111111
100C10C0E1
1P100C00E1
1111111111
