1111111111
100C10C001
1P100C0001
1111111111
