1111111111
100C10C0E1
10100C0001
1111111111
