1111111111
100C1PC0E1
1P100C0001
1111111111
