1111111111
100C10C001
1P100C00E1
1000000111
10000001C1
1111111111
