1111111111
100C10C001
1P100C00C1
1000000111
10000001E1
1111111111
