111111111111
1AAAAAAAAAA1
1BBBBBBBBBB1
1CCCCCCCCCC1
1DDDDDDDDDD1
1EEEEEEEEEE1
1FFFFFFFFFF1
1GGGGGGGGGG1
1HHHHHHHHHH1
1IIIIIIIIII1
1JJJJJJJJJJ1
1KKKKKKKKKK1
1LLLLLLLLLL1
1MMMMMMMMMM1
111111111111
