111111111111111
1AAAAAAAAAAAAA1
1BBBBBBBBBBBBB1
1CCCCCCCCCCCCC1
1DDDDDDDDDDDDD1
1EEEEEEEEEEEEE1
111111111111111
