11111
1AAA1
1BBB1
1CCC1
11111
