1111111111
1P00010001
100101C1E1
10010001C1
1111111111
