1111111111
100C10C001
1P100C0001
1010000101
10100001E1
1111111111
