111111111111111111111111
1P10000000000000000000E1
1010111000000000000001C1
101C1C100101011100011C11
1011101001C101C0000010C1
100000100111011100001011
1011100001C101C000001001
100C11100101011100001101
101100000000000000001001
101000000000000000000011
101111111111111111001C01
1001000001C00100C1101001
100001C100010C010C1010C1
111111111111111111111111
