1111111111
100C10C0E1
1010000001
1P100C0001
1111111111
